11111111111111111
11111111111111111
11111110111111111
1111PC00EC00000C1
11111110000001111
11111111111111111

