11111111111111111
10100010000000001
10000010000000011
1000P00000EC00001
1C000000000000001
11111111111111111

