1111111111111111111111111111111111
1P000000000000C000000C0000000010E1
1000010100100000101001000000000011
10000100101010100010010000000100C1
101000000C00C000000000000000000111
10100000000000000000000000000000C1
1111111111111111111111111111111111