111111111111111
1P0000000000001
100001010010001
100001001010101
100000000000C01
1000000000000E1
111111111111111