111111111111111111111111111111111111111111111111111111111111111111
1100000000000000000000C111100000000001000000C1111000000000C1111111
110000000000000000000001111000000000000000000000000000000000111111
1P000000000000111100000011C000000000000000000000000000000000011111
1100000000000011111C0000110000000001111111100000000011111000001111
111111111100001111111000000000000111110C11100000001111C00000000111
11111111111000111111110000000001111111000010000000111C000000000011
111111111110001111111000000000111111110000000000000111C10000000011
111111100000000C11110000000000111111110000000000000001111000000011
1111C0000000000000110000000000011111110000000000000000000000000111
1100000000000000000000000000000000C1110000000000000111100000000011
11000000000000000C11111100000000000111C000000000000111111000000001
11C0000000000000011111111C0000000011111100000000011111111000000001
111111111100001111111000000000000111111110000000001111111000011111
111111111110001111111100000000011111111110000000000011100C00001111
111111111110001111111000000000111111111110000000000001000000111111
111111100000000C11110000000000111111111100000000000000000001111111
1111C0000000000000110000000000011111111C00000000000000000000011111
110000000000000000000000000000000000000000000011000000011000000111
11000000000000000C111111000000000000000000001111000000111000000011
11C0000000000000011111111C00000000111100000111111C000111110000E111
111111111111111111111111111111111111111111111111111111111111111111